abjad|abjat
aktif|aktip
aktivitas|aktifitas
andal|handal
analisis|analisa
andal|handal
antre|antri
asas|azas
apotek|apotik
atlet|atlit
atmosfer|atmosfir
cabai|cabe
cendekia|cendikia
cenderamata|cinderamata
detail|detil
definisi|difinisi
diagnosis|diagnosa
embus|hembus
ekstra|extra
ekstrem|ekstrim
februari|pebruari
fondasi|pondasi
formal|formil
frekuensi|frekwensi
gizi|gisi
hafal|hapal
hakikat|hakekat
hipotesis|hipotesa
hierarki|hirarki
ijazah|ijasah
izin|ijin
imbau|himbau
isap|hisap
istri|isteri
jadwal|jadual
jenazah|jenasah
jenderal|jendral
justru|justeru
karier|karir
kategori|katagori
komplet|komplit
konferensi|konperensi
kongres|konggres
konkret|kongkrit
kreativitas|kreatifitas
kualifikasi|kwalifikasi
kualitatif|kwalitatif
kuantitatif|kwantitatif
kualitas|kwalitas
kuitansi|kwitansi
lubang|lobang
maaf|maâ€™af
makhluk|mahluk
masjid|mesjid
merek|merk
meterai|meterei
metode|metoda
miliar|milyar
misi|missi
modern|moderen
mubazir|mubadir
mulia|mulya
mungkir|pungkir
museum|museum
napas|nafas
narasumber|nara
nasihat|nasehat
objek|obyek
objektif|obyektif
paham|faham
paspor|pasport
peduli|perduli
pikir|fikir
praktik|praktek
provinsi|propinsi
rabu|rebo
risiko|resiko
sah|syah
sekadar|sekedar
sentral|central
silakan|silahkan
sistem|sistim
saksama|seksama
subjek|subyek
subjektif|subyektif
surga|sorga
tampak|nampak
teladan|tauladan
teknik|tehnik
teknologi|tehnologi
telanjur|terlanjur
telantar|terlantar
terampil|trampil
vila|villa
wakaf|waqaf
wujud|ujud
yudikatif|yudikatip
ubah|rubah
zaman|jaman
Alpa|Alfa
Analisis|Analisa
Apotek|Apotik
Baik|Bae
Balas|Bales
Belum|Belom
Capai|Capek
Dalam|Dalem
Dapat|Dapet
Disahkan|Disyahkan
Februari|Febuari
Hakikat|Hakekat
Hilang|Ilang
Hutang|Utang
Ijazah|Ijasah
Ikhlas|Iklas
Ingat|Inget
Itikad|Itikat
Izin|Ijin
Jadual|Jadwal
Jumat|Jumaat
Kantung|Kantong
Karena|Karna
Karier|Karir
Kasier|Kasir
Karisma|Kharisma
Kepada|Kapada
Kerap|Kerab
Kaidah|Kaedah
Khatulistiwa|Katulistiwa
Khawatir|Kawatir
Konkret|Konkrit
Kuadrat|Kwadrat
Kualitas|Kwalitas
Kuantum|Kwantum
Kuis|Kuiz
Lazim|Lajim
Losin|Lusin
Maaf|Maap
Macam|Macem
Malas|Males
Manfaat|Manpaat
Nomor|Nomer
Materai|Matere
Mengesampingkan|Mengenyampingkan
Mengubah|Merubah
Padat|Padet
Pelanggan|Langganan
Pensil|Pinsil
Pertanggung jawaban|Pertanggungjawab
Pihak|Fihak
Populer|Popular
Rapat|Rapet
Sampai|Ampe
Selesai|Selese
Seperti|Kayak
Silakan|Silahkan
Sistem|Sistim
Aksi|Action
Aktivitas|Aktifitas
Aktif|Aktip
Analisis|Analisa
Anarki|Anarkhi
Anggota|Anggauta
Antre|Antri
Asas|Azas
Atmosfer|Atmosfir
Biosfer|Biosfir
Cenderamata|Cinderamata
Cepat|Cepet
Dalam|Dalem
Debit|Debet
Devaluasi|Defaluasi
Detail|Detil
Diagnosis|Diagnosa
Definisi|Difinisi
Doa|Do'a
Diam|Diem
Daftar|Daptar
Dipersilakan|Dipersilahkan
Ekstrem|Ekstrim
Ekuivalen|Ekwivalen
Elite|Elit
Familier|Familiar
Frekuensi|Frekwensi
Glucose|Glukosa
Grup|Group
Genting|Genteng
Gubuk|Gubug
Hakikat|Hakekat
Hectare|Hektar
Heterogen|Hetrogen
Hipotesis|Hipotesa
Hipotek|Hipotik
Hierarki|Hirarkhi
Hutang|Utang
Himbau|Imbau
Hanya|Cuma
Habis|Abis
Ideology|Idiologi
Ikhlas|Ihlas
Ijazah|Ijasah
Izin|Ijin
Institute|Institute
Interogasi|Interograsi
Introspeksi|Interospeksi
Interupsi|Intrupsi
Institut|Institute
Imaginasi|Imajinasi
Jadwal|Jadual
Zaman|Jaman
Kaidah|Kaedah
Kalau|Kalo
Karier|Karir
Kongres|Konggres
Konferensi|Konperensi
Kreativitas|Kreatifitas
Kualifikasi|Kwalifikasi
Kualitas|Kwalitas
Kuantitas|Kwantitas
Kuitansi|Kwitansi
Kategori|Katagori
Kuota|Kwota
Kredit|Kridit
Linear|Linier
Manajemen|Managemen
Masal|Missal
Manajer|Menejer
Mengubah|Merubah
Meterai|Meterei
Metode|Metoda
Monarki|Monarkhi
Moral|Moril
Museum|Museum
Miliar|Milyar
Netralisasi|Netralisir
Nomor|Nomer
Objek|Obyek
Omzet|Omset
Pengkreditan|Pengreditan
Praktik|Praktek
Risiko|Resiko
Sistem|Sistim
Teknik|Tehnik
Teknologi|Tekhnologi
Universitas|University
Varietas|Varitas
